1111111111111111111111111111111111
1000000000000000000000000000000001
10P0000000000000000000000010000001
1000000000000000000000000000000001
1000010000000000000000000000000001
1000000000000000000000000000000001
1000000000000000000000000000000001
1000000000000000000000000000000001
1000000001000000000000000000000001
1000000000000000000000000000000001
1000000000000000000000000000000001
1000000000000000000000000000000001
1000000000000000000100000000000001
1000000000000000000000000000000001
1000000000000000000000000000000001
1000000000000000000P00000000010001
1000000000000000000000000000000001
1000000100000000000000000000000101
1000000000000000000000000000000001
1111111111111111111111111111111111