NO ./path
SO ./path_to_the_south_texture
WE ./path_to_the_west_texture
EA ./path_to_the_east_texture.xpm
F 222,2,1
C 225,30,0



1111111111111111
1              1
1             1N1
1111111111111111

















