NO                      ./path_to_the_north_texture
                        EA                  ./path_to_the_east_texture
    SO                          ./path_to_the_south_texture

                    WE                      ./path_to_the_west_texture
F 220,100,0
C                             225,30,0
11111111111111111111111   111111
110000000011000000000001   11011
100100000000000000000000111111
1111111110110000011100001
100000000011111000001110111111111
1111011111    111101110000001
1111011111111111101010010001
11111111111111111111111111111
11000000110101011100000010001
10000000000000001100000010001
1000000000000000110101001011
11000001110111011111011110101
11110111 111 101 101111010001
11111111 1111111 1111111111111
1100000110101011111011110S01
11110111 1110101 101111010001
111111 111111111111111111111

1111111
1011
11111




