F 220,100,0
NO ./textures/textures/NO.xpm
SO ./textures/textures/4k.xpm
WE ./textures/textures/SO.xpm
EA ./textures/textures/wood.xpm
C 74,166,254

        111111111111111111111
        100000010000000000001
        101100001000010000001
        100100000000100000001
11111111101100000000000000001
10000000001100000000011111111
11110111111111000000000000001
111101111111110N0000000010001
11000000110101011100010001001
100000000000000011000D0001001
10000000000000001101010010001
11000001101010111110111100011
11110111 1110101 101111010001
11111111 1111111 111111111111
















