F 50,50,50
NO ./textures/game_texture/WALL1.xpm
SO ./textures/game_texture/WALL1.xpm
WE ./textures/game_texture/WALL1.xpm
EA ./textures/game_texture/WALL1.xpm
C 0,33,70

        111111111111111111111 11111
        100000010000000000001 10D101
        101100001000010000001  11 1
        100100000000100000001
11111111101100000000000000001
10000000001100000000011111111
11110111111111000000000000001
111101111111110N0000000011001
1100000011010101110001000D001
100000000000000011000D0001001
10000000000000001101010010001
11000001101010111110111100011
11110111 1110101 101111010001
11111111 1111111 111111111111
















