NO ./path
SO ./path_to_the_south_texture
WE ./path_to_the_west_texture
EA ./path_to_the_east_texture
F 222,2,2
C 225,30,0



                                        11
        111111111111111111111111    11111111
        1000000000110000000000001    10000111
        1011000001110000000000001    111111111
        1001000000000000000000001
111111111011000001110000000000001
1000000000110000001110111111111111
11110111111111100000010001
1110111111101 1010100100011
1100000011011111100000010001
1000000000000001100000010001
10000000000000001101010010001
1100000110101011111011110011
1111011 1110101 101N11101011
111111 11111111 11111111111
















